20.ox
....oo..............
....................
.....o..............
o...................
...o.....o........o.
.........oo.........
..............o.....
....................
.............oo.....
....o......yarrak...
...................o
...........o...o.o..
....o.......o.......
...o................
...........o..o.....
....................
o....o............o.
...........o.o......
......o.o...........
.........o..........
